Anatomical Direction->AnatomicalDirection
Bone System Location->BoneSystemLocation
Cancer Histology Subtype->CancerSubtype
Cancer Histology Type->CANCERHISTOLOGY
Clinical History Heading->CLINICALHISTORY
Comments Heading->COMMENTS
Final Diagnosis Heading->FinalDiagnosis
Flow Cytometry Heading->FlowCytometry
Internal X-reference->InternalX
Laterality->Laterality
Lymphatic System Location->LymphaticLocation
Macroscopic/Gross Description Heading->GrossHeading
Microscopic Heading->Microscopic
Nature of Specimen Heading->NatureOfSpecimen
Negative Findings Phraseology->NegativeFindings
Neoplasm Behaviour->NeoplasmBehaviour
Neoplasm Descriptive Grade->NeoplasmDescriptiveGrade
Neoplasm Grade-Score Name->NeoplasmGradeName
Neoplasm Grade Value->NeoplasmGradeValue
Neoplasm Morphology->NeoplasmMorphology
Neoplasm Score Value->NeoplasmScoreValue
Neural System Location->NeuralSystemLocation
Organ/Body Structure->Organ
Positive Findings Phraseology->PositiveFindings
Primary Origin of Neoplasm->PrimaryOrigin
Relative Distance->RelativeDistance
Relative Location->RelativeLocation
Skin System Location->SkinSystem
Specimen Identifier->SpecimenIdentifier
Specimen Tissue/Substance->SpecimenTissue
Supplementary Report Heading->SupplementaryReport
Synoptic Report Heading->SynopticReport
Vascular System Location->VascularSystem