Ontology:: Acronym
APA Neuro Cluster:: APANEUROCLUSTER
APA Occupational and Employment cluster:: APAOCUEMPLOY
APA Statistical Cluster:: APASTATISTICAL
APA Tests and Testing cluster:: APATANDT
APA Treatment Cluster:: APATREATMENT
AdaLab ontology:: ADALAB
AdaLab-meta ontology:: ADALAB-META
Adverse Event Reporting Ontology:: AERO
Allen Brain Atlas (ABA) Adult Mouse Brain Ontology:: ABA-AMB
Allergy Detector II:: ALLERGYDETECTOR
Alzheimer's disease ontology:: ADO
Amino Acid Ontology:: AMINO-ACID
Amphibian Gross Anatomy Ontology:: AAO
Amphibian Taxonomy Ontology:: ATO
An ontology for experimental actions:: EXACT
Anatomic Pathology Lexicon:: PATHLEX
Anatomical Entity Ontology:: AEO
Anatomical Therapeutic Chemical Classification:: ATC
Ancestry Ontology:: ANCESTRO
Animal Natural History and Life History Ontology:: ADW
Animal Trait Ontology for Livestock:: ATOL
Anthology of Biosurveillance Diseases:: ABD
Apollo Structured Vocabulary:: APOLLO-SV
Artificial Intelligence Rheumatology Consultant System Ontology:: AI-RHEUM
Ascomycete Phenotype Ontology:: APO
Asthma Ontology:: AO
Autism DSM-ADI-R ontology:: ADAR
Autism Spectrum Disorder Phenotype Ontology:: ASDPTO
BIBFRAME 2.0:: BIBFRAME
BIological:: PROCESS
BRENDA Tissue and Enzyme Source Ontology:: BTO
Bacterial interlocked Process ONtology:: BIPON
Basic Formal Ontology:: BFO
Bebasin:: GAYAA
Behaviour Change Technique Taxonomy:: BCTT
Beta Cell Genomics Ontology:: OBI_BCGO
Bilingual Ontology of Alzheimer's Disease and Related Diseases:: ONTOAD
BioAssay Ontology:: BAO
BioMedBridges Diabetes Ontology:: DIAB
BioModels Ontology:: BIOMODELS
BioPAX Ontology of Biological Pathways:: BP
BioPortal Metadata Ontology:: BP-METADATA
BioTop Ontology:: BT
Biodiversity Ontology:: BOF
Bioinformatics Web Service Ontology:: OBIWS
Biological Collections Ontology:: BCO
Biological Imaging Methods Ontology:: FBbi
Biological Observation Matrix Ontology:: BIOMO
Biologie Hors Nomenclature:: BHN
Biomedical Image Ontology:: BIM
Biomedical Informatics Research Network Project Lexicon:: BIRNLEX
Biomedical Research Integrated Domain Group Model:: BRIDG
Biomedical Resource Ontology:: BRO
Biomedical Topics:: BMT
Bionutrition Ontology:: BNO
Bleeding History Phenotype Ontology:: BHO
Body System Terms from ICD11:: ICD11-BODYSYSTEM
Bone Dysplasia Ontology:: BDO
Bone and Cartilage Tissue Engineering Ontology:: BCTEO
Botryllus schlosseri anatomy and development ontology:: BSAO
Brain Region & Cell Type terminology:: BRCT
Breast Cancer Grading Ontology:: BCGO
Breast Tissue Cell Lines Ontology:: MCBCC
Bro_Name:: BRO_ACRONYM
Brucellosis Ontology:: IDOBRU
C. elegans Development Vocabulary:: WB-LS
C. elegans Gross Anatomy Vocabulary:: WB-BT
C. elegans Phenotype Vocabulary:: WB-PHENOTYPE
CARRE Risk Factor ontology:: CARRE
CEDAR Provisional Classes:: CEDARPC
CEDAR Value Sets:: CEDARVS
CNO_NAME:: CNO_ACRONYM
COMODI:: COMODI
CPTAC Proteomics Pipeline Infrastructure Ontology:: CPTAC
CYTOKINE:: CYTO
Cancer Chemoprevention Ontology:: CANCO
Cancer Research and Management ACGT Master Ontology:: ACGT-MO
Cardiac Electrophysiology Ontology:: EP
Cell Behavior Ontology:: CBO
Cell Culture Ontology:: CCONT
Cell Cycle Ontology:: CCO
Cell Line Ontology:: CLO
Cell Line Ontology [by Mahadevan]:: MCCL
Cell Ontology:: CL
Cellular microscopy phenotype ontology:: CMPO
Cereal Plant Development Ontology:: GRO-CPD
Cereal Plant Gross Anatomy Ontology:: GRO-CPGA
Cerebrotendinous Xanthomatosis Ontology:: CTX
Cerrado concepts and plant community dynamics:: CCON
Chemical Entities of Biological Interest Ontology:: CHEBI
Chemical Information Ontology:: CHEMINF
Chemical Methods Ontology:: CHMO
Chemical Process:: PROCCHEMICAL
Children's Health Exposure Analysis Resource:: CHEAR
Cigarette Smoke Exposure Ontology:: CSEO
Ciona intestinalis Anatomy and Development Ontology:: CIINTEADO
Ciona savignyi Anatomy and Development Ontology:: CISAVIADO
Clinical Measurement Ontology:: CMO
Clinical Signs and Symptoms Ontology:: CSSO
Clinical Study Ontology:: CSO
Clinical Trials Ontology:: CTO
Clusters of Orthologous Groups (COG) Analysis Ontology:: CAO
Coding Symbols for a Thesaurus of Adverse Reaction Terms:: COSTART
Cognitive Atlas Ontology:: COGAT
Cognitive Paradigm Ontology:: COGPO
Common Anatomy Reference Ontology:: CARO
Common Terminology Criteria for Adverse Events:: CTCAE
Comparative Data Analysis Ontology:: CDAO
Computational Neuroscience Ontology:: CNO
Computer Assisted Brain Injury Rehabilitation Ontology:: CABRO
Computer Cluster:: APACOMPUTER
Computer Retrieval of Information on Scientific Projects Thesaurus:: CRISP
Computer-Based Patient Record Ontology:: CPRO
Congenital Heart Defects Ontology:: CHD
Content Archive Resource Exchange Lexicon:: CARELEX
Crop Ontology:: CO
Current Procedural Terminology:: CPT
DCMI Type Vocabulary:: DCMITYPE
DICOM Controlled Terminology:: DCM
Data Science Education Ontology:: DSEO
Dataset processing:: ONL-DP
DebugIT Core Ontology:: DCO-DEBUGIT
Defen:: MRO
Dengue Fever Ontology:: IDODEN
Dependency Layered Ontology for Radiation Oncology:: DLORO
Dermatology Lexicon:: DERMLEX
Diabetes Mellitus Diagnosis Ontology:: DDO
Diabetes Mellitus Treatment Ontology:: DMTO
Diagnosis Ontology of Clinical Care Classification:: DOCCC
Diagnostic Ontology:: DIAGONT
Dictyostelium Discoideum Anatomy Ontology:: DDANAT
Disease core ontology applied to Rare Diseases:: HRDO
Disorders cluster:: APADISORDERS
Dispedia Core Ontology:: DCO
Drosophila Development Ontology:: FB-DV
Drosophila Gross Anatomy Ontology:: FB-BT
Drug Interaction Knowledge Base Ontology:: DIKB
Dublin Core:: DC
EDAM Bioimaging Ontology:: EDAM-BIOIMAGING
EDAM bioinformatics operations, types of data, data formats, identifiers, and topics:: EDAM
EDDA Publication Types Taxonomy:: EDDA_PT
EDDA Study Designs Taxonomy:: EDDA
Eagle-I Research Resource Ontology:: ERO
Early Pregnancy Ontology:: EPO
Educational Cluster:: APAEDUCLUSTER
Electrocardiography Ontology:: ECG
Electronic Care Plan:: ECP
Eligibility Feature Hierarchy:: ELIG
Emergency care ontology:: ONTOLURGENCES
Emotion Ontology:: MFOEM
Environment Ontology:: ENVO
Environment Ontology for Livestock:: EOL
Enzyme Mechanism Ontology:: EMO
Enzyme Reaction Ontology for annotating Partial Information of chemical transformation:: PIERO
Enzyme Structure Function Ontology:: ESFO
Epigenome Ontology:: EGO
Epilepsy Ontology:: EPILONT
Epilepsy Syndrome Seizure Ontology:: ESSO
Epoch Clinical Trial Ontology:: CTONT
Ethnicity Ontoloy:: EO
Evidence and Conclusion Ontology:: ECO
Experimental Conditions Ontology:: XCO
Experimental Factor Ontology:: EFO
Exposure Ontology:: EXO
Family Health History Ontology:: FHHO
Fanconi Anemia Ontology:: IFAR
Fern Ontology:: FO
Fire Ontology:: FIRE
Fission Yeast Phenotype Ontology:: FYPO
Flora Phenotype Ontology:: FLOPO
Fly Taxonomy:: FB-SP
FlyBase Controlled Vocabulary:: FB-CV
FlyGlycoDB:: FLYGLYCODB
FoodOn:: FOODON
Foundational Model of Anatomy:: FMA
Functional Therapeutic Chemical Classification System:: FTC
Fungal Gross Anatomy Ontology:: FAO
G Protein-Coupled Receptor BioAssays Ontology:: BAO-GPCR
Galen Ontology:: GALEN
Gazetteer:: GAZ
GenEpiO:: GENEPIO
Gene Expression Ontology:: GEXO
Gene Ontology:: GO
Gene Ontology Extension:: GO-EXT
Gene Regulation Ontology:: GRO
General Formal Ontology:: GFO
General Formal Ontology for Biology:: GFO-BIO
Genetic Test:: GTO
Genome Component Ontology:: GCO
Genomic Clinical Decision Support Ontology:: GENE-CDS
Genomic Feature and Variation Ontology:: GFVO
GeoSpecies Ontology:: GEOSPECIES
Getty Vocabulary Program ontology:: GVP
Glioblastoma:: GBM
GlycoRDF:: GLYCORDF
Glycomics Ontology:: GLYCO
GoMapMan:: GMM
Graphical Pathway Markup Language:: GPML
Growth Medium Onotology:: GMO
HGeneCodonOntology:: HCODONONT
HIV ontology:: HIV
HIVCompoundRels:: HIVCRS
HIVOntologymain.owl:: HIVO004
Habronattus Courtship Ontology:: HC
Halocynthia aurantium Anatomy and Development Ontology:: HAAURAADO
Halocynthia roretzi Anatomy and Development Ontology:: HAROREADO
Health Level Seven Reference Implementation Model, Version 3:: HL7
Healthcare Common Procedure Coding System:: HCPCS
Heart Failure Ontology:: HFO
Host Pathogen Interactions Ontology:: HPIO
Human Dermatological Disease Ontology:: DERMO
Human Developmental Anatomy Ontology, abstract version 1:: EHDAA
Human Developmental Anatomy Ontology, abstract version 2:: EHDAA2
Human Developmental Anatomy Ontology, timed version:: EHDA
Human Disease Ontology:: DOID
Human Genome Organization Gene Symbols:: HUGO
Human Interaction Network Ontology:: HINO
Human Phenotype Ontology:: HP
Human Physiology Simulation Ontology:: HUPSON
Hymenoptera Anatomy Ontology:: HAO
ISO 19115:: ISO19115
ISO 19115 Role Codes:: ISO19115ROLES
ISO-15926-2_2003_annotations:: ISO-ANNOTATIONS
ISO-15926-2_2003_entityMembership:: ENTITY
ISO-15926-2_2003_entityMembershipCandidates:: ENTITYCANDIDATES
ISO-15926-2_2003_inverseRoles:: INVERSEROLES
ISO-15926-2_2003_oil:: ISO-15926-2_2003
Image and Data Quality Assessment Ontology:: IDQA
Immune Disorder Ontology:: IMMDIS
Immunogenetics Ontology:: IMGT-ONTOLOGY
Infectious Disease Ontology:: IDO
Influenza Ontology:: FLU
Information Artifact Ontology:: IAO
Informed Consent Ontology:: ICO
InterNano Nanomanufacturing Taxonomy:: InterNano
Interaction Network Ontology:: INO
Interaction Ontology:: IXNO
International Classification for Nursing Practice:: ICNP
International Classification for Patient Safety:: ICPS
International Classification of  External Causes of Injuries:: ICECI
International Classification of Diseases, Version 10:: ICD10
International Classification of Diseases, Version 10 - Clinical Modification:: ICD10CM
International Classification of Diseases, Version 10 - Procedure Coding System:: ICD10PCS
International Classification of Diseases, Version 9 - Clinical Modification:: ICD9CM
International Classification of Functioning, Disability and Health:: ICF
International Classification of Primary Care:: ICPC
International Classification of Primary Care - 2 PLUS:: ICPC2P
International Classification of Wellness:: ICW
Interventionnelle Non MÃ©dicamenteuse (INM):: INM-NPI
KB_Bio_101:: AURA
Kinetic Simulation Algorithm Ontology:: KISAO
Knowledge Object Reference Ontology:: KORO
Lipid Ontology:: LIPRO
Livestock Breed Ontology:: LBO
Livestock Product Trait Ontology:: LPT
Loggerhead Nesting Ontology:: LHN
Logical Observation Identifier Names and Codes:: LOINC
MKN_10_test:: MKN_10_TEST
Magnetic Resonance Dataset Acquisition Ontology:: ONL-MR-DA
Maize Gross Anatomy Ontology:: ZEA
Major Histocompatibility Complex Ontology:: MHC
Malaria Ontology:: IDOMAL
Mammalian Phenotype Ontology:: MP
Mass Spectrometry Ontology:: MS
Master Drug Data Base Clinical Drugs:: MDDB
Material:: MATR
Material Compound:: MATRCOMPOUND
Material Element:: MATRELEMENT
Material Mineral:: MINERAL
Material Natural Resource:: MNR
Material Organic Compound:: MOC
Material Rock:: MATRROCK
Material Rock Igneouus:: MATRROCKIGNEOUS
Mathematical Modelling Ontology:: MAMO
Measurement Method Ontology:: MMO
Medaka Fish Anatomy and Development Ontology:: MFO
Medical Dictionary for Regulatory Activities:: MEDDRA
Medical Educational Resource Aggregator:: MERA
Medical Error Ontology:: MEDEON
Medical Subject Headings:: MESH
Medical Web Lifestyle Aggregator:: MWLA
Medical image simulation:: OntoVIP
MedlinePlus Health Topics:: MEDLINEPLUS
Menelas Project Top-Level Ontology:: TOP-MENELAS
Mental Functioning Ontology:: MF
Mental State Assessment:: ONL-MSA
Metagenome Sample Vocabulary:: MSV
Metagenome and Microbes Environmental Ontology:: MEO
MicroRNA Ontology:: MIRNAO
Microarray and Gene Expression Data Ontology:: MO
Microbial Culture Collection Vocabulary:: MCCV
Microbial Typing Ontology:: TYPON
Minimal Anatomical Terminology:: MAT
Minimal Information about any Sequence (MIxS) Controlled Vocabularies:: MIXSCV
Minimal Information about any Sequence Ontology:: MIXS
Minimal Standard Terminology of Digestive Endoscopy:: MSTDE
Minimal Standard Terminology of Digestive Endoscopy, French:: MSTDE-FRE
Mobile Genetic Element Ontology:: MEGO
Molecular Interaction Map:: MIM
Molgula occidentalis Anatomy and Development Ontology:: MOOCCIADO
Molgula occulta Anatomy and Development Ontology:: MOOCCUADO
Molgula oculata Anatomy and Development Ontology:: MOOCULADO
Monogenean Ontology:: MONO
Mosquito Gross Anatomy Ontology:: TGMA
Mosquito Insecticide Resistance Ontology:: MIRO
Mouse Adult Gross Anatomy Ontology:: MA
Mouse Experimental Design Ontology:: MEDO
Mouse Gross Anatomy and Development Ontology:: EMAP
Mouse Pathology Ontology:: MPATH
Multiple sclerosis ontology:: MSO
MyOntoServiceFull_FallDetection:: FALL
NGS ontology:: NGSONTO
NHS Quality Indicators:: NHSQI2009
NIDM-Results:: NIDM-RESULTS
NIH NLM Value Sets:: NLMVS
NMR-Instrument Component of Metabolomics Investigations Ontology:: NMR
Name Reaction Ontology:: RXNO
NanoParticle Ontology:: NPO
National Cancer Institute Thesaurus:: NCIT
National Center for Biotechnology Information (NCBI) Organismal Classification:: NCBITAXON
National Drug Data File:: NDDF
National Drug File - Reference Terminology:: NDFRT
National Institutes of Health Stroke Scale Ontology:: NIHSS
Natural Products Ontology:: NATPRO
Neglected Tropical Disease Ontology:: NTDO
Neomark Oral Cancer Ontology, version 3:: NEOMARK3
Neomark Oral Cancer Ontology, version 4:: NEOMARK4
Neural ElectroMagnetic Ontology:: NEMO
Neural Motor Recovery Ontology:: NEUMORE
Neural-Immune Gene Ontology:: NIGO
Neuro Behavior Ontology:: NBO
NeuroMorpho.Org brain region ontologies:: NMOBR
NeuroMorpho.Org species ontology:: NMOSP
Neuroscience Domain Insight Graph:: NEUDIGS
Neuroscience Information Framework (NIF) Cell Ontology:: NIFCELL
Neuroscience Information Framework (NIF) Dysfunction Ontlogy:: NIFDYS
Neuroscience Information Framework (NIF) Standard Ontology:: NIFSTD
Neuroscience Information Framework (NIF) Subcellular Ontology:: NIFSUBCELL
Non-Pharmacological Interventions (NPIs):: NPI
Non-Randomized Controlled Trials Ontology:: NONRCTO
Non-coding RNA Ontology:: NCRO
Norwegian national quality registries- Variabelbibliotek for medisinske kvalitetsregistre:: NORREG
Nurse Administrator:: ADMIN
Nurse Surgical:: SURGICAL
Nurse Transitional:: TRANS
Nurse triage:: TRIAGE
Nursing Care Coordination Ontology:: NCCO
Nursing Interventions Classification:: NIC
OWL-Time:: TIME
OWL_XML_Tool5:: FDSAJFAHSJK
Obstetric and Neonatal Ontology:: ONTONEO
Online Mendelian Inheritance in Man:: OMIM
OntoFood:: OF
OntoPsychia, social module:: ONTOPSYCHIA
Ontological Knowledge Base Model for Cystic Fibrosis:: ONTOKBCF
Ontology Metadata Vocabulary:: OMV
Ontology for Biobanking:: OBIB
Ontology for Biomedical Investigations:: OBI
Ontology for Drug Discovery Investigations:: DDI
Ontology for General Medical Science:: OGMS
Ontology for Genetic Disease Investigations:: OGDI
Ontology for Genetic Interval:: OGI
Ontology for Genetic Susceptibility Factor:: OGSF
Ontology for MicroRNA Target:: OMIT
Ontology for Newborn Screening Follow-up and Translational Research:: ONSTR
Ontology for Parasite LifeCycle:: OPL
Ontology of Adverse Events:: OAE
Ontology of Alternative Medicine, French:: ONTOMA
Ontology of Biological and Clinical Statistics:: OBCS
Ontology of Cardiovascular Drug Adverse Events:: OCVDAE
Ontology of Chinese Medicine for Rheumatism:: OCMR
Ontology of Clinical Research:: OCRE
Ontology of Consumer Health Vocabulary:: OCHV
Ontology of Core Data Mining Entities:: ONTODM-CORE
Ontology of Craniofacial Development and Malformation:: OCDM
Ontology of Data Mining Investigations:: ONTODM-KDD
Ontology of Datatypes:: ONTODT
Ontology of Drug Neuropathy Adverse Events:: ODNAE
Ontology of Experimental Variables and Values:: OOEVV
Ontology of Genes and Genomes:: OGG
Ontology of Genes and Genomes - Mouse:: OGG-MM
Ontology of Geographical Region:: OGR
Ontology of Glucose Metabolism Disorder:: OGMD
Ontology of Homology and Related Concepts in Biology:: HOM
Ontology of Host-Microbe Interactions:: OHMI
Ontology of Language Disorder in Autism:: LDA
Ontology of Liver for Radiology:: ONLIRA
Ontology of Medically Related Social Entities:: OMRSE
Ontology of Nuclear Toxicity:: ONTOTOXNUC
Ontology of Physical Exercises:: OPE
Ontology of Physics for Biology:: OPB
Ontology of Pneumology:: ONTOPNEUMO
Ontology of Vaccine Adverse Events:: OVAE
Open Biological and Biomedical Ontologies Relationship Types:: OBOREL
Open Food Safety Model Repository:: OFSMR
Orphanet Rare Disease Ontology:: ORDO
Orthologous Group Ontology:: OGROUP
Orthology Ontology:: ORTH
PAV Provenance, Authoring and Versioning:: PAV
PGxO:: PGXO
PLOS Thesaurus:: PLOSTHES
Parasite Experiment Ontology:: PEO
Parkinson's Disease Ontology:: PDON
Pathogen Transmission Ontology:: PTRANS
Pathogenic Disease Ontology:: PDO
Pathway Ontology:: PW
Pathway Terminology System:: PTS
Pediatric Terminology:: PEDTERM
Phallusia fumigata Anatomy and Development Ontology:: PHFUMIADO
Phallusia mammillata Anatomy and Development Ontology:: PHMAMMADO
PharmGKB Ontology:: PHARMGKB
Pharmacogenomic Relationships Ontology:: PHARE
Pharmacovigilance Ontology:: PVONTO
PhenX Phenotypic Terms:: PHENX
PhenomeBLAST Ontology:: PHENOMEBLAST
Phenotypic Quality Ontology:: PATO
Phylogenetic Ontology:: PHYLONT
Phylogenetics Ontology:: PHAGE
Physical Medicine and Rehabilitation:: PMR
Physician Data Query:: PDQ
Physico-Chemical Methods and Properties:: FIX
Physico-Chemical Process:: REX
Pipeline Patterns Ontology:: PP
Plant Anatomy:: PAE
Plant Diversity Ontology:: PDO_CAS
Plant Environmental Conditions:: PECO
Plant Experimental Assay Ontology:: PEAO
Plant Ontology:: PO
Plant Structure Development Stage:: PSDS
Plant Trait Ontology:: PTO
Population and Community Ontology:: PCO
Porifera Ontology:: PORO
Portfolio Management Application:: PMA
Pre-eclampsia Ontology:: PE-O
Probabilistic Knowledge Assembly Ontology:: PANDA
Proteasix Ontology:: PXO
Protein Modification Ontology:: PSIMOD
Protein Ontology:: PR
Protein-Protein Interaction Ontology:: PPIO
Protein-ligand interaction ontology:: PLIO
Proteomics Data and Process Provenance Ontology:: PROPREO
Provenance Ontology:: PROVO
Pseudogene:: pseudo
Psychology Ontology:: APAONTO
Pulmonary Embolism Ontology:: PE
Quantitative Imaging Biomarker Ontology:: QIBO
Quantities, Units, Dimensions, and Types Ontology:: QUDT
RDL:: RDL
RNA Ontology:: RNAO
RNRMU:: RNRMU
Radiation Oncology Ontology:: ROO
Radiation Oncology Structures Ontology:: ROS
Radiology Lexicon:: RADLEX
Radiomics Ontology:: RO
Randomized Controlled Trials Ontology:: RCTONT
Rat Strain Ontology:: RS
Read Clinical Terminology Version 2:: RCTV2
Read Codes, Clinical Terms Version 3 (CTV3):: RCD
Reference Sequence Annotation:: RSA
RegenBase ontology:: RB
Regional Healthcare System Interoperability and Information Exchange Measurement Ontology:: HEIO
Regulation of Gene Expression Ontolology:: REXO
Regulation of Transcription Ontology:: RETO
Reproductive Trait and Phenotype Ontology:: REPO
Research Network and Patient Registry Inventory Ontology:: RNPRIO
Resource of Asian Primary Immunodeficiency Diseases (RAPID) Phenotype Ontology:: RPO
Rheumatoid Arthritis ontology:: RAO
Robert Hoehndorf Version of MeSH:: RH-MESH
Role Ontology:: ROLEO
RxNORM:: RXNORM
SMART Protocols:: SP
SMASH Ontology:: SMASH
SNOMED CT:: SNOMEDCT
SO 639-2: Codes for the Representation of Names of Languages:: ISO639-2
Sage Bionetworks Synapse Ontology:: SYN
Sample Processing and Separation Techniques Ontology:: SEP
Santa Barbara Coastal Observation Ontology:: OBOE-SBC
Scientific Evidence Based Genetic Testing Ontology:: IGTO
Semantic DICOM Ontology:: SEDI
Semantic Types Ontology:: STY
Semantic Web for Earth and Environment Technology Ontology:: SWEET
Semanticscience Integrated Ontology:: SIO
Sequence Types and Features Ontology:: SO
Sickle Cell Disease Ontology:: SCDO
Simulation Delivery and Documentation Deviations:: SD3
Single-Nucleotide Polymorphism (SNP) Ontology:: SNPO
Situation-Based Access Control Ontology:: SITBAC
Skin Physiology Ontology:: SPO
Sleep Domain Ontology:: SDO
Software Ontology:: SWO
Solanaceae Phenotype Ontology:: SPTO
Soy Ontology:: SOY
Spatial Ontology:: BSPO
Spider Ontology:: SPD
Statistics Ontology:: STATO
Student Health Record Ontology:: SHR
Stuff Ontology:: STUFF
Subcellular Anatomy Ontology:: SAO
Suggested Ontology for Pharmacogenomics:: SOPHARM
Surgical Secondary Events:: SSE
Symptom Ontology:: SYMP
Syndromic Surveillance Ontology:: SSO
Synthetic Biology Open Language Visual Ontology:: SBOL
SysMO JERM Ontology of Systems Biology for Micro-Organisms:: JERM
Systematized Nomenclature of Medicine, International Version:: SNMI
Systems Biology Ontology:: SBO
Systems Chemical Biology and Chemogenomics Ontology:: CHEMBIO
TDWG Specimen LSID Ontology:: TDWGSPEC
Taxonomic Rank Vocabulary:: TAXRANK
Taxonomy for Rehabilitation of Knee Conditions:: TRAK
Teleost Anatomy Ontology:: TAO
Teleost Taxonomy Ontology:: TTO
Terminological and Ontological Knowledge Resources Ontology:: TOK
Terminology for the Description of Dynamics:: TEDDY
The Biblioteko Ontology:: BIBLIOTEK-O
The Drug Ontology:: DRON
The Drug-Drug Interactions Ontology:: DINTO
The Ecosystem Ontology:: ECSO
The Potential Drug-drug Interaction and Potential Drug-drug Interaction Evidence Ontology:: DIDEO
Tick Gross Anatomy Ontology:: TADS
Time Event Ontology:: TEO
Tissue Microarray Ontology:: TMA
Traditional Medicine Constitution Value Set:: TM-CONST
Traditional Medicine Meridian Value Sets:: TM-MER
Traditional Medicine Other Factors Value Set:: TM-OTHER-FACTORS
Traditional Medicine Signs and Symptoms Value Set:: TM-SIGNS-AND-SYMPTS
Translational Medicine Ontology:: TMO
Tribolium Ontology:: TRON
Uber Anatomy Ontology:: UBERON
Units Ontology:: UNITSONT
Units of Measurement Ontology:: UO
Upper-Level Cancer Ontology:: CANONT
VIVO Ontology for Researcher Discovery:: VIVO
VIVO-Integrated Semantic Framework:: VIVO-ISF
Vaccination Informed Consent Ontology:: VICO
Vaccine Ontology:: VO
Variation Ontology:: VARIO
Venom Ontology:: CU-VO
Vertebrate Homologous Organ Group Ontology:: VHOG
Vertebrate Skeletal Anatomy Ontology:: VSAO
Vertebrate Taxonomy Ontology:: VTO
Vertebrate Trait Ontology:: VT
Veterans Health Administration National Drug File:: VANDF
Vital Sign Ontology:: VSO
Web-Service Interaction Ontology:: WSIO
Wheat Trait Ontology:: CO-WHEAT
WikiPathways:: WIKIPATHWAYS
World Health Organization (WHO) Adverse Reaction Terminology:: WHO-ART
XEML Environment Ontology:: XEO
Xenopus Anatomy and Development Ontology:: XAO
Zebrafish Anatomy and Development Ontology:: ZFA
agen poker:: MASTERBANDAR88
apalegal:: LEGALAPATEST2
computer network:: CN
eNanoMapper:: ENM
go-plus:: GO-PLUS
insectH:: INSECTH
koinhoki:: KOINHOKI
legalapa:: LEGALAPA
schema.org:: SCHEMA
suicideonto:: suicideo
test:: TEST
